100000000000000000000000000000000000000000000000000000000000000000000000000000000000000000000000000000000000000000000000000000000000000001
100000000000000000000000000000000000000000000000000000000000000000000000000000000000000000000000000000000000000000000000000000000000000001
100000000000000000000000000000000000000000000000000000000000000000000000000000000000000000000000000000000000000000000000000000000000000001
100000000000000000000111111111000000000000000000000000000000400000000000000000000000000000000000000000000000000000000000000000000000000000
100000000000000000000000000000000000000000000000000000000000500000000000000000000000000000000000000000000000000000000000040000000000000000
100000000000000001000140000000000000000000000000000000000000000000000000000000000000000000000000000000000000000000000000050000000000000001
100000000400000000000152222222200000000000000000000000000000000000000000000000000000000000000000000000000222222222222222222222222222222221
100000003400000000000111111111100000110000040000000000000000000000000000400000000222222222000000002222222211111111111111111111111111111111
100000000555000000000000000000000000110000050000000000000000000000000000500000000111111111000000001111111111000000000000000000000000000001
100000000000000000004000000000000000000000000000002222222222222222000000000000000000000000000000000000000000000000000000000000000000000001
100000000000000000005000000000000000000000000000001111111111111111000000000000000040000000000000000000000000000000000000000000000000000001
122222222222222222222000000000000000000000000000001111111111111111000000000000000050000000000000000000000000000000000222222222222222222221
111111111111111111111222222222222222222222222222222222222222222222222222222222222222222222222222222222222222222222222111111111111111111111
111111111111111111111111111111111111111111111111111111111111111111111111111111111111111111111111111111111111111111111111111111111111111111
111111111111111111111111111111111111111111111111111111111111111111111111111111111111111111111111111111111111111111111111111111111111111111
111111111111111111111111111111111111111111111111111111111111111111111111111111111111111111111111111111111111111111111111111111111111111111
111111111111111111111111111111111111111111111111111111111111111111111111111111111111111111111111111111111111111111111111111111111111111111
111111111111111111111111111111111111111111111111111111111111111111111111111111111111111111111111111111111111111111111111111111111111111111